"aa" = (/turf/simulated/wall/concrete,/area/warfare/homebase/red)
"ab" = (/obj/structure/dirt_wall,/obj/machinery/door/blast/shutters/open{id = "red"},/turf/simulated/floor/dirty/indestructable,/area/warfare/homebase/red)
"ac" = (/obj/machinery/door/airlock/multi_tile/metal/maintenance,/obj/machinery/door/blast/shutters/open{id = "red"},/turf/simulated/floor/tiled,/area/warfare/homebase/red)
"ad" = (/obj/machinery/door/blast/shutters/open{id = "red"},/turf/simulated/floor/tiled,/area/warfare/homebase/red)
"ae" = (/obj/structure/poster/red,/turf/simulated/wall/concrete,/area/warfare/homebase/red)
"af" = (/obj/structure/closet/crate,/obj/item/clothing/mask/gas,/obj/item/clothing/mask/gas,/obj/item/clothing/mask/gas,/obj/item/clothing/mask/gas,/obj/structure/torchwall{icon_state = "torchwall0"; dir = 4},/turf/simulated/floor/tiled/dark,/area/warfare/homebase/red)
"ag" = (/obj/structure/reagent_dispensers/watertank,/turf/simulated/floor/tiled/dark,/area/warfare/homebase/red)
"ah" = (/obj/structure/closet/crate,/obj/item/clothing/mask/gas,/obj/item/clothing/mask/gas,/obj/item/clothing/mask/gas,/obj/item/clothing/mask/gas,/turf/simulated/floor/tiled/dark,/area/warfare/homebase/red)
"ai" = (/turf/simulated/floor/tiled/dark,/area/warfare/homebase/red)
"aj" = (/obj/machinery/button/remote/blast_door/lever{id = "red"; pixel_y = 32},/turf/simulated/floor/tiled/dark,/area/warfare/homebase/red)
"ak" = (/obj/structure/torchwall{icon_state = "torchwall0"; dir = 8},/turf/simulated/floor/tiled/dark,/area/warfare/homebase/red)
"al" = (/obj/structure/table/steel,/obj/structure/torchwall{icon_state = "torchwall0"; dir = 4},/turf/simulated/floor/tiled/dark,/area/warfare/homebase/red)
"am" = (/obj/structure/table/steel,/obj/structure/sink{pixel_y = 20},/turf/simulated/floor/tiled/dark,/area/warfare/homebase/red)
"an" = (/obj/structure/table/steel,/turf/simulated/floor/tiled/dark,/area/warfare/homebase/red)
"ao" = (/obj/structure/table/steel,/obj/item/reagent_containers/food/condiment/small/saltshaker,/obj/item/reagent_containers/food/condiment/small/peppermill,/turf/simulated/floor/tiled/dark,/area/warfare/homebase/red)
"ap" = (/obj/structure/table/steel,/obj/machinery/microwave,/turf/simulated/floor/tiled/dark,/area/warfare/homebase/red)
"aq" = (/obj/machinery/button/remote/blast_door/lever{id = "red"; pixel_x = -32},/turf/simulated/floor/tiled,/area/warfare/homebase/red)
"ar" = (/obj/structure/torchwall{icon_state = "torchwall0"; dir = 8},/turf/simulated/floor/tiled,/area/warfare/homebase/red)
"as" = (/obj/structure/closet/crate,/obj/random/canned_food,/obj/random/canned_food,/turf/simulated/floor/tiled,/area/warfare/homebase/red)
"at" = (/obj/structure/closet/crate,/obj/random/canned_food,/obj/random/canned_food,/obj/random/canned_food,/turf/simulated/floor/tiled,/area/warfare/homebase/red)
"au" = (/obj/machinery/button/remote/blast_door/lever{id = "red"; pixel_y = 32},/turf/simulated/floor/tiled,/area/warfare/homebase/red)
"av" = (/obj/structure/bed/chair,/turf/simulated/floor/tiled/dark,/area/warfare/homebase/red)
"aw" = (/obj/structure/bed/chair,/obj/structure/torchwall{icon_state = "torchwall0"; dir = 4},/turf/simulated/floor/tiled,/area/warfare/homebase/red)
"ax" = (/turf/simulated/floor/tiled,/area/warfare/homebase/red)
"ay" = (/obj/structure/closet/crate,/obj/item/ammo_magazine/mc9mmt/machinepistol,/obj/item/ammo_magazine/mc9mmt/machinepistol,/obj/item/ammo_magazine/mc9mmt/machinepistol,/obj/item/ammo_magazine/mc9mmt/machinepistol,/turf/simulated/floor/tiled,/area/warfare/homebase/red)
"az" = (/obj/structure/closet/crate,/obj/item/melee/classic_baton/trench_club,/obj/item/melee/classic_baton/trench_club,/turf/simulated/floor/tiled,/area/warfare/homebase/red)
"aA" = (/obj/structure/table/steel,/obj/machinery/cooker/candy,/turf/simulated/floor/tiled/dark,/area/warfare/homebase/red)
"aB" = (/obj/structure/bed/chair,/turf/simulated/floor/tiled,/area/warfare/homebase/red)
"aC" = (/obj/structure/table/steel,/obj/structure/torchwall{icon_state = "torchwall0"; dir = 8},/turf/simulated/floor/tiled/dark,/area/warfare/homebase/red)
"aD" = (/obj/structure/closet/crate,/obj/item/melee/classic_baton/trench_club,/turf/simulated/floor/tiled,/area/warfare/homebase/red)
"aE" = (/obj/structure/bed/chair,/obj/structure/torchwall{icon_state = "torchwall0"; dir = 8},/turf/simulated/floor/tiled,/area/warfare/homebase/red)
"aF" = (/obj/structure/table/steel,/obj/machinery/cooker/cereal,/turf/simulated/floor/tiled/dark,/area/warfare/homebase/red)
"aG" = (/obj/structure/closet/secure_closet/freezer/fridge,/turf/simulated/floor/tiled/dark,/area/warfare/homebase/red)
"aH" = (/obj/structure/bed/chair{icon_state = "chair_preview"; dir = 4},/turf/simulated/floor/tiled/dark,/area/warfare/homebase/red)
"aI" = (/obj/structure/bed/chair{icon_state = "chair_preview"; dir = 1},/obj/structure/torchwall{icon_state = "torchwall0"; dir = 4},/turf/simulated/floor/tiled,/area/warfare/homebase/red)
"aJ" = (/obj/structure/bed/chair{icon_state = "chair_preview"; dir = 1},/turf/simulated/floor/tiled,/area/warfare/homebase/red)
"aK" = (/obj/structure/torchwall{icon_state = "torchwall0"; dir = 4},/turf/simulated/floor/tiled/dark,/area/warfare/homebase/red)
"aL" = (/obj/structure/bed/chair{icon_state = "chair_preview"; dir = 1},/obj/structure/torchwall{icon_state = "torchwall0"; dir = 8},/turf/simulated/floor/tiled,/area/warfare/homebase/red)
"aM" = (/obj/structure/table/woodentable,/turf/simulated/floor/tiled/dark,/area/warfare/homebase/red)
"aN" = (/obj/structure/bed/chair{icon_state = "chair_preview"; dir = 8},/turf/simulated/floor/tiled/dark,/area/warfare/homebase/red)
"aO" = (/obj/structure/closet/secure_closet/freezer/meat,/turf/simulated/floor/tiled/dark,/area/warfare/homebase/red)
"aP" = (/obj/structure/table/woodentable,/obj/item/storage/fancy/cigarettes/jerichos,/obj/item/flame/candle,/obj/item/flame/lighter/random,/turf/simulated/floor/tiled,/area/warfare/homebase/red)
"aQ" = (/obj/structure/table/woodentable,/obj/item/flame/candle,/obj/item/storage/firstaid/regular,/turf/simulated/floor/tiled,/area/warfare/homebase/red)
"aR" = (/obj/structure/table/woodentable,/obj/item/storage/fancy/cigarettes/luckystars,/obj/item/flame/candle,/obj/item/flame/lighter/random,/obj/item/ammo_box/rifle,/turf/simulated/floor/tiled,/area/warfare/homebase/red)
"aS" = (/obj/structure/table/woodentable,/obj/item/flame/candle,/obj/item/storage/box/matches,/turf/simulated/floor/tiled,/area/warfare/homebase/red)
"aT" = (/obj/structure/table/woodentable,/obj/item/flame/candle,/obj/item/device/compass,/obj/item/device/compass,/obj/item/device/compass,/obj/item/device/compass,/obj/item/device/compass,/turf/simulated/floor/tiled,/area/warfare/homebase/red)
"aU" = (/obj/structure/table/woodentable,/obj/item/storage/fancy/cigarettes,/obj/item/flame/candle,/obj/item/flame/lighter/random,/turf/simulated/floor/tiled,/area/warfare/homebase/red)
"aV" = (/obj/machinery/vending/dinnerware,/turf/simulated/floor/tiled/dark,/area/warfare/homebase/red)
"aW" = (/obj/structure/table/woodentable,/obj/item/flame/candle,/obj/item/storage/firstaid/surgery,/turf/simulated/floor/tiled,/area/warfare/homebase/red)
"aX" = (/obj/structure/table/woodentable,/obj/item/flame/candle,/obj/item/storage/fancy/cigarettes/carcinomas,/obj/item/ammo_box/rifle,/turf/simulated/floor/tiled,/area/warfare/homebase/red)
"aY" = (/obj/structure/table/woodentable,/obj/item/flame/candle,/obj/item/ammo_box/shotgun,/turf/simulated/floor/tiled,/area/warfare/homebase/red)
"aZ" = (/obj/structure/table/woodentable,/obj/item/flame/candle,/obj/item/storage/fancy/cigarettes/carcinomas,/turf/simulated/floor/tiled,/area/warfare/homebase/red)
"ba" = (/obj/structure/table/woodentable,/obj/item/flame/candle,/obj/item/wirecutters,/obj/item/storage/firstaid/regular,/turf/simulated/floor/tiled,/area/warfare/homebase/red)
"bb" = (/obj/structure/closet/chefcloset,/turf/simulated/floor/tiled/dark,/area/warfare/homebase/red)
"bc" = (/obj/machinery/cooker/oven,/turf/simulated/floor/tiled/dark,/area/warfare/homebase/red)
"bd" = (/obj/machinery/cooker/grill,/obj/structure/torchwall{icon_state = "torchwall0"; dir = 1},/turf/simulated/floor/tiled/dark,/area/warfare/homebase/red)
"be" = (/obj/machinery/cooker/fryer,/turf/simulated/floor/tiled/dark,/area/warfare/homebase/red)
"bf" = (/obj/structure/bed/chair{icon_state = "chair_preview"; dir = 1},/turf/simulated/floor/tiled/dark,/area/warfare/homebase/red)
"bg" = (/turf/template_noop,/area/template_noop)
"bh" = (/turf/simulated/floor/dirty/indestructable,/area/warfare/homebase/red)
"bi" = (/obj/structure/table/steel,/obj/item/gun/projectile/talon,/turf/simulated/floor/tiled/dark,/area/warfare/homebase/red)
"bj" = (/obj/structure/closet/crate,/obj/item/ammo_magazine/mc9mmt/machinepistol,/obj/item/ammo_magazine/mc9mmt/machinepistol,/obj/item/ammo_magazine/mc9mmt/machinepistol,/obj/item/ammo_magazine/mc9mmt/machinepistol,/obj/item/ammo_magazine/c45rifle/akarabiner,/turf/simulated/floor/tiled,/area/warfare/homebase/red)
"bk" = (/obj/structure/closet/crate,/obj/item/ammo_box/rifle,/obj/item/ammo_box/rifle,/turf/simulated/floor/tiled,/area/warfare/homebase/red)
"bl" = (/obj/machinery/door/airlock/multi_tile/metal/maintenance{dir = 1; icon_state = "door_closed"; name = "Emergency Medical"},/turf/simulated/floor/tiled/dark,/area/warfare/homebase/red)
"bm" = (/obj/effect/landmark/corpse/chef,/obj/effect/decal/cleanable/blood,/turf/simulated/floor/tiled/dark,/area/warfare/homebase/red)
"bn" = (/obj/structure/closet/crate,/obj/item/wirecutters,/obj/item/wirecutters,/obj/item/storage/firstaid/regular,/turf/simulated/floor/tiled/dark,/area/warfare/homebase/red)
"bo" = (/obj/structure/closet/crate,/obj/item/wirecutters,/obj/item/storage/firstaid/regular,/turf/simulated/floor/tiled/dark,/area/warfare/homebase/red)
"bp" = (/obj/machinery/door/airlock/multi_tile/metal/maintenance,/turf/simulated/floor/tiled,/area/warfare/homebase/red)
"bq" = (/obj/structure/closet/cabinet,/obj/item/gun/energy/h4,/turf/simulated/floor/tiled/dark,/area/warfare/homebase/red)
"br" = (/obj/effect/decal/cleanable/blood/gibs/up,/turf/simulated/floor/tiled/dark,/area/warfare/homebase/red)
"bs" = (/obj/structure/curtain,/turf/simulated/floor/tiled/dark,/area/warfare/homebase/red)
"bt" = (/obj/structure/table/woodentable,/obj/item/device/compass,/turf/simulated/floor/tiled/dark,/area/warfare/homebase/red)
"bu" = (/obj/structure/table/woodentable,/obj/item/flame/candle,/obj/item/storage/fancy/cigarettes/carcinomas,/turf/simulated/floor/tiled/dark,/area/warfare/homebase/red)
"bv" = (/obj/structure/torchwall{icon_state = "torchwall0"; dir = 4},/obj/effect/decal/cleanable/blood/gibs/down,/turf/simulated/floor/tiled/dark,/area/warfare/homebase/red)
"bw" = (/obj/structure/table/woodentable,/obj/item/flame/candle,/obj/item/storage/box/matches,/turf/simulated/floor/tiled/dark,/area/warfare/homebase/red)
"bx" = (/obj/structure/toilet{icon_state = "toilet00"; dir = 4},/turf/simulated/floor/tiled/dark,/area/warfare/homebase/red)
"by" = (/obj/machinery/shower{icon_state = "shower"; dir = 8},/turf/simulated/floor/tiled/dark,/area/warfare/homebase/red)
"bz" = (/obj/effect/landmark/corpse/miner,/obj/effect/decal/cleanable/blood/gibs/up,/obj/effect/decal/cleanable/blood,/turf/simulated/floor/tiled/dark,/area/warfare/homebase/red)
"bA" = (/obj/structure/torchwall{icon_state = "torchwall0"; dir = 8},/obj/effect/decal/cleanable/blood/gibs/up,/turf/simulated/floor/tiled/dark,/area/warfare/homebase/red)
"bB" = (/obj/effect/landmark/corpse/marooned_officer,/obj/effect/decal/cleanable/blood/gibs/down,/obj/effect/decal/cleanable/blood,/turf/simulated/floor/tiled/dark,/area/warfare/homebase/red)
"bC" = (/obj/structure/torchwall{icon_state = "torchwall0"; dir = 1},/turf/simulated/floor/tiled/dark,/area/warfare/homebase/red)
"bD" = (/obj/structure/table/woodentable,/obj/item/storage/fancy/cigarettes/jerichos,/obj/item/flame/candle,/obj/item/flame/lighter/random,/turf/simulated/floor/tiled/dark,/area/warfare/homebase/red)
"bE" = (/obj/structure/toilet{icon_state = "toilet00"; dir = 8},/turf/simulated/floor/tiled/dark,/area/warfare/homebase/red)
"bF" = (/obj/structure/bed,/turf/simulated/floor/tiled/dark,/area/warfare/homebase/red)
"bG" = (/obj/structure/closet/cabinet,/turf/simulated/floor/tiled/dark,/area/warfare/homebase/red)
"bH" = (/obj/structure/crematorium{icon_state = "crema1"; dir = 4},/turf/simulated/floor/tiled/dark,/area/warfare/homebase/red)
"bI" = (/obj/machinery/button/crematorium{pixel_y = 32},/turf/simulated/floor/tiled/dark,/area/warfare/homebase/red)
"bJ" = (/obj/machinery/optable,/turf/simulated/floor/tiled/dark,/area/warfare/homebase/red)
"bK" = (/obj/machinery/computer/operating,/turf/simulated/floor/tiled/dark,/area/warfare/homebase/red)
"bL" = (/obj/random/mining_hostile,/turf/simulated/floor/tiled,/area/warfare/homebase/red)
"bM" = (/obj/structure/bed/chair/wheelchair,/turf/simulated/floor/tiled/dark,/area/warfare/homebase/red)
"bN" = (/turf/simulated/floor/tiled/ramp{icon_state = "ramptop"; dir = 4},/area/warfare/homebase/red)
"bO" = (/obj/random/mining_hostile,/turf/simulated/floor/tiled/dark,/area/warfare/homebase/red)
"bP" = (/turf/simulated/mineral,/area/warfare/homebase/red)
"bR" = (/obj/structure/torchwall{icon_state = "torchwall0"; dir = 1},/turf/simulated/floor/tiled,/area/warfare/homebase/red)
"bS" = (/obj/structure/table/steel,/obj/item/storage/firstaid/surgery,/obj/item/FixOVein,/turf/simulated/floor/tiled/dark,/area/warfare/homebase/red)
"bT" = (/obj/structure/closet/secure_closet/medical2{req_access = newlist()},/turf/simulated/floor/tiled/dark,/area/warfare/homebase/red)
"bU" = (/obj/structure/closet/medical_wall,/turf/simulated/wall/concrete,/area/warfare/homebase/red)
"bV" = (/obj/structure/sign/medholo,/turf/simulated/wall/concrete,/area/warfare/homebase/red)
"bW" = (/obj/structure/closet/crate,/obj/item/reagent_containers/ivbag/blood/AMinus,/obj/item/reagent_containers/ivbag/blood/AMinus,/obj/item/reagent_containers/ivbag/blood/APlus,/obj/item/reagent_containers/ivbag/blood/APlus,/obj/item/reagent_containers/ivbag/blood/BMinus,/obj/item/reagent_containers/ivbag/blood/BMinus,/obj/item/reagent_containers/ivbag/blood/BPlus,/obj/item/reagent_containers/ivbag/blood/BPlus,/obj/item/reagent_containers/ivbag/blood/OMinus,/obj/item/reagent_containers/ivbag/blood/OMinus,/obj/item/reagent_containers/ivbag/blood/OPlus,/obj/item/reagent_containers/ivbag/blood/OPlus,/turf/simulated/floor/tiled/dark,/area/warfare/homebase/red)
"bX" = (/obj/structure/table/rack,/obj/item/storage/firstaid/fire,/obj/item/storage/firstaid/fire,/obj/item/storage/firstaid/fire,/obj/item/storage/firstaid/fire,/turf/simulated/floor/tiled/dark,/area/warfare/homebase/red)
"bY" = (/obj/structure/table/rack,/obj/item/storage/firstaid/toxin,/obj/item/storage/firstaid/toxin,/obj/item/storage/firstaid/toxin,/obj/item/storage/firstaid/toxin,/turf/simulated/floor/tiled/dark,/area/warfare/homebase/red)
"bZ" = (/obj/structure/table/rack,/obj/item/storage/firstaid/adv,/obj/item/storage/firstaid/adv,/obj/item/storage/firstaid/adv,/obj/item/storage/firstaid/adv,/turf/simulated/floor/tiled/dark,/area/warfare/homebase/red)
"ca" = (/obj/structure/table/rack,/obj/item/storage/firstaid/regular,/obj/item/storage/firstaid/regular,/obj/item/storage/firstaid/regular,/obj/item/storage/firstaid/regular,/turf/simulated/floor/tiled/dark,/area/warfare/homebase/red)
"cb" = (/obj/structure/torchwall{icon_state = "torchwall0"; dir = 8},/obj/structure/table/steel,/obj/item/reagent_containers/spray/cleaner/warfare,/obj/item/reagent_containers/spray/cleaner/warfare,/obj/item/reagent_containers/spray/cleaner/warfare,/obj/item/reagent_containers/spray/cleaner/warfare,/turf/simulated/floor/tiled/dark,/area/warfare/homebase/red)
"cd" = (/obj/machinery/sleeper,/turf/simulated/floor/tiled/dark,/area/warfare/homebase/red)
"ce" = (/obj/machinery/body_scanconsole{icon_state = "body_scannerconsole"; dir = 4},/turf/simulated/floor/tiled/dark,/area/warfare/homebase/red)
"cf" = (/obj/machinery/bodyscanner{icon_state = "body_scanner_0"; dir = 4},/turf/simulated/floor/tiled/dark,/area/warfare/homebase/red)
"cg" = (/obj/machinery/vending/medical{req_access = newlist()},/turf/simulated/floor/tiled/dark,/area/warfare/homebase/red)
"ch" = (/obj/structure/sink{dir = 4; icon_state = "sink"; pixel_x = 16},/turf/simulated/floor/tiled/dark,/area/warfare/homebase/red)
"ci" = (/obj/structure/table/steel,/obj/item/crutches,/obj/item/crutches,/obj/item/crutches,/turf/simulated/floor/tiled/dark,/area/warfare/homebase/red)
"cj" = (/obj/structure/closet/secure_closet/medical1/warfare,/turf/simulated/floor/tiled/dark,/area/warfare/homebase/red)
"ck" = (/obj/structure/torchwall{icon_state = "torchwall0"; dir = 1},/obj/structure/iv_drip,/turf/simulated/floor/tiled/dark,/area/warfare/homebase/red)
"cl" = (/obj/machinery/sleeper{icon_state = "sleeper_0"; dir = 1},/turf/simulated/floor/tiled/dark,/area/warfare/homebase/red)
"cn" = (/obj/structure/bed/roller,/turf/simulated/floor/tiled/dark,/area/warfare/homebase/red)

(1,1,1) = {"
bhbhbhbhbhbhbhbhbhbhbhbhbhbhbhbhbhbhbhbhbhbhbhbhbhbhbhbhbhbhbhbhbhbhbhbhbh
aaaaaaaaabaaaaaaaaaaaaaaaaaaaaacadaaaaaaaaababaeaaaaaaaaaaaaaaababaaaaaaaa
aaafagahaiajakaaalambiaoanapaaaqaraaasatauaxaxaxaxayaaaaasatauaxaxaxaxazaa
aaaiaiaiaiaiaiaaaAaibmbraiaCaaaxaxaaasataxaxaxaxaxayaaaaasataxaxaxaxaxaDaa
aaaiaiavavaiaiaeaFbrbraiaiaGaaaxaxaaawaBaxaxaxaxaBaEaaaaawaBaxaxaxaxaBaEaa
aaaKaHaMaMaNakaaaGaiaiaiaiaOaaaxaraaaPaQaxaxaxaxaRaSaeaaaSaTaxaxbLaxaSaUaa
aeaiaHaMaMaNaiaaaVaiaiaiaiaiaaaxaxaaaWaSaxaxaxaxaXaYaaaaaUaTaxaxaxaxaZbaaa
aaaiaHaMaMaNaiaaaOaibbbcbdbeaaaxaxaaaIaJbLaxaxaxaJaLaaaaaIaJaxaxaxaxaJaLaa
aaaKaibfbfaibAaaaaaiaaaaaaaaaaaxaraaazaxaxaxaxaxbjbkaaaabkaxaxaxaxaxaxbjaa
aaaibOaiaibrbzaiaiaiaiaiaiaiaiaxaxaaaDaxaxaxaxaxbjbkaaaabkaxaxaxaxaxaxbjaa
aaaiaiavavaiaiaiavavaiaiaiaiblaxaxaiaiaiaiaiaiaiaiaiaiaiaiaiaiaiaiaiaiaiaa
aaaKaHaMaMaNaiaHaMaMaNaiaiakaaaxaxblaiaiaiaiaiaiaibnbnaiaibnboaiaiaiaiaiaa
aaaiaHaMaMaNaiaHaMaMaNaiaiaiaabpaxaaaKaiakaaaabsaaaaaabsaaaaaabsaaaaaabsaa
aaaiaHaMaMaNaiaHaMbtaNaiaibuaaaxaxaaaabsaaaaaKaiaiaaaKaiaiaaaKaiaiaaaKaiai
aaaKaibfbfaiaiaibfbfaiaiaibwaaaxaraabxaibyaabxaiaiaabxaiaiaabxaiaiaabxaiai
aaaibCaiaibCaibCaiaibCaiaibDaaaxaxaabxbCbEaabFbtbqaabFbtbGaabFbtbGaabFbtbG
aaaaaaaaaaaaaaaaaaaaaaaaaeaaaaaxaxaaaaaaaaaaaaaaaaaaaaaaaaaaaaaaaaaaaaaaaa
aabHaibIaabJbKaiaiaabMbMaiaiaiaxaxaxbNbPbPbPbPbgbgbgbgbgbgbgbgbgbgbgbgbgbg
aaaiaiaiaaaKaiaiaibsaiaiaiaiblaxbRaxbNbPbPbPbPbgbgbgbgbgbgbgbgbgbgbgbgbgbg
aabHaiaiaabSaiaibTbUaKaibOakbVaaaaaaaaaaaaaaaabgbgbgbgbgbgbgbgbgbgbgbgbgbg
aaaiaiakaaaaaaaaaaaaaiaiaiaiaibWbXbYbZcacbaaaabgbgbgbgbgbgbgbgbgbgbgbgbgbg
aabHaiaiaaaKcdaicdaicecfaiaiaiaibrbraiaiaicgaabgbgbgbgbgbgbgbgbgbgbgbgbgbg
aaaiaiaiaeaiaiaiaiaiaiaiaichaabvbBaiaiaiaiciaabgbgbgbgbgbgbgbgbgbgbgbgbgbg
aabHaiakaaaiaiaiaiaicecfaiakaacjcjaickaiaicgaabgbgbgbgbgbgbgbgbgbgbgbgbgbg
aaaiaiaibsaiclaiclaicncncncnaaaaaaaaaaaaaaaaaabgbgbgbgbgbgbgbgbgbgbgbgbgbg
aaaaaaaaaaaaaaaaaaaaaaaaaaaaaabgbgbgbgbgbgbgbgbgbgbgbgbgbgbgbgbgbgbgbgbgbg
"}
