"a" = (/obj/item/landmine,/turf/simulated/floor/dirty/indestructable,/area/mine/explored)
"b" = (/obj/structure/landmine,/turf/simulated/floor/dirty/indestructable,/area/mine/explored)
"c" = (/obj/structure/barbwire,/turf/simulated/floor/dirty/indestructable,/area/mine/explored)
"d" = (/obj/structure/barbwire,/obj/structure/barbwire,/turf/simulated/floor/dirty/indestructable,/area/mine/explored)
"e" = (/obj/structure/gravemarker/random,/obj/random/bolt_action,/obj/item/storage/bag/cash,/turf/simulated/floor/dirty/indestructable,/area/mine/explored)

(1,1,1) = {"
bbbbbbbbbb
bcccccccdb
bcbbbbbbcb
bcbccccbcb
bcbceacbcb
bcbcaacbcb
bcbdcccbcb
bcbbbbbbcb
bdccccccdb
bbbbbbbbbb
"}
