"af" = (/obj/effect/landmark/map_data{height = 2},/turf/simulated/mineral,/area/space)
"ap" = (/obj/structure/banner/red,/turf/simulated/wall/concrete,/area/warfare/siegezones/outdoors)
"cu" = (/turf/simulated/floor/tiled/ramp{dir = 4},/area/warfare/siegezones)
"cx" = (/turf/simulated/floor/tiled/ramp{dir = 8},/area/warfare/siegezones)
"gN" = (/obj/structure/torchwall{dir = 4; icon_state = "torchwall0"},/turf/simulated/floor/dirty/indestructable,/area/warfare/siegezones/outdoors)
"kh" = (/turf/simulated/floor/holofloor/tiled,/area/warfare/siegezones/outdoors)
"kQ" = (/obj/structure/barbwire,/turf/simulated/floor/dirty/indestructable,/area/warfare/siegezones/outdoors)
"nS" = (/turf/simulated/floor/dirty/tough,/area/warfare/siegezones/outdoors/wavewall)
"pt" = (/obj/structure/sign/kitchen,/turf/simulated/mineral,/area/warfare/siegezones/outdoors)
"pu" = (/obj/structure/defensive_barrier,/turf/simulated/floor/dirty/indestructable,/area/warfare/siegezones/outdoors)
"px" = (/obj/structure/sign/redcross,/turf/simulated/mineral,/area/warfare/siegezones/outdoors)
"qG" = (/obj/structure/sign/neon/armory,/turf/simulated/mineral,/area/warfare/siegezones/outdoors)
"qN" = (/turf/simulated/mineral,/area/warfare/siegezones/outdoors)
"rb" = (/obj/structure/sign/warning/detailed,/turf/simulated/wall/concrete/strong,/area/warfare/siegezones/outdoors)
"rq" = (/obj/structure/destruction_computer/blue,/turf/simulated/floor/dirty/indestructable,/area/warfare/siegezones/outdoors)
"rZ" = (/turf/simulated/floor/tiled/ramp{dir = 1},/area/warfare/siegezones)
"ta" = (/obj/structure/dirt_wall,/obj/structure/dirt_wall,/turf/simulated/floor/dirty/indestructable,/area/warfare/siegezones/outdoors)
"ue" = (/obj/structure/banner/blue,/turf/simulated/wall/concrete,/area/warfare/siegezones/outdoors)
"vA" = (/obj/structure/defensive_barrier{dir = 8},/turf/simulated/floor/dirty/indestructable,/area/warfare/siegezones/outdoors)
"wg" = (/obj/structure/defensive_barrier{dir = 4},/turf/simulated/floor/dirty/indestructable,/area/warfare/siegezones/outdoors)
"ww" = (/turf/simulated/floor/dirty/indestructable,/area/warfare/siegezones/outdoors)
"xc" = (/obj/structure/sign/kitchen,/turf/simulated/wall/concrete/strong,/area/warfare/siegezones/outdoors)
"xp" = (/turf/simulated/floor/dirty/tough,/area/warfare/battlefield/no_mans_land)
"xY" = (/turf/simulated/floor/tiled/ramp,/area/warfare/siegezones)
"yq" = (/obj/structure/dirt_wall,/turf/simulated/floor/dirty/indestructable,/area/warfare/siegezones/outdoors)
"yC" = (/obj/structure/sign/warning,/turf/simulated/mineral,/area/warfare/battlefield/no_mans_land)
"Aj" = (/obj/structure/torchwall{dir = 4; icon_state = "torchwall0"},/turf/simulated/floor/trench,/area/warfare/siegezones/outdoors)
"Am" = (/obj/structure/bed/chair{dir = 4; icon_state = "chair_preview"},/turf/simulated/floor/trench,/area/warfare/siegezones/outdoors)
"As" = (/obj/structure/poster/red,/turf/simulated/wall/concrete,/area/warfare/siegezones/outdoors)
"AN" = (/obj/structure/barbwire,/obj/structure/barbwire,/turf/simulated/floor/dirty/indestructable,/area/warfare/siegezones/outdoors)
"BC" = (/obj/structure/torchwall{dir = 8; icon_state = "torchwall0"},/turf/simulated/floor/dirty/indestructable,/area/warfare/siegezones/outdoors)
"Eu" = (/turf/simulated/floor/dirty/indestructable,/area/warfare/battlefield/no_mans_land)
"Ha" = (/turf/simulated/mineral,/area/space)
"HB" = (/obj/structure/poster/blue,/turf/simulated/wall/concrete,/area/warfare/siegezones/outdoors)
"Jt" = (/obj/structure/defensive_barrier,/turf/simulated/floor/holofloor/tiled,/area/warfare/siegezones/outdoors)
"KG" = (/obj/structure/bed,/turf/simulated/floor/trench,/area/warfare/siegezones/outdoors)
"KX" = (/turf/simulated/floor/tiled,/area/warfare/siegezones/outdoors)
"NN" = (/turf/simulated/floor/trenches,/area/warfare/siegezones/outdoors)
"Rf" = (/obj/structure/bed/chair{dir = 8; icon_state = "chair_preview"},/turf/simulated/floor/trench,/area/warfare/siegezones/outdoors)
"Ss" = (/obj/structure/sign/redcross,/turf/simulated/wall/concrete/strong,/area/warfare/siegezones/outdoors)
"Vx" = (/obj/structure/landmine,/turf/simulated/floor/dirty/indestructable,/area/warfare/siegezones/outdoors)
"Xd" = (/turf/simulated/floor/dirty/tough,/area/warfare/siegezones/outdoors)
"XQ" = (/turf/simulated/open,/area/warfare/siegezones)
"Yo" = (/obj/structure/torchwall{dir = 8; icon_state = "torchwall0"},/turf/simulated/floor/trench,/area/warfare/siegezones/outdoors)
"YX" = (/obj/structure/sign/neon/armory,/turf/simulated/wall/concrete/strong,/area/warfare/siegezones/outdoors)
"Zc" = (/turf/simulated/floor/trench,/area/warfare/siegezones/outdoors)
"ZV" = (/turf/simulated/floor/dirty/tough,/area/warfare/battlefield/trench_section)

(1,1,1) = {"
HaHaHaHaHaHaHaHaHaHaHaHaHaHaHaHaHaHaHaHaHaHaHaHaHaHaHaHaHaHaHaHaHaHaHaHaHaHaHaHaHaHaHaHaHaHaHaHaHaHaHaHaHa
HaHaHaHaHaHaHaHaHaHaHaHaHaHaHaHaHaHaHaHaHaHaHaHaHaHaHaHaHaHaHaHaHaHaHaHaHaHaHaHaHaHaHaHaHaHaHaHaHaHaHaHaHa
HaHaHaHaHaHaHaHaHaHaHaHaHaHaHaHaHaHaHaHaHaHaHaHaHaHaHaHaHaHaHaHaHaHaHaHaHaHaHaHaHaHaHaHaHaHaHaHaHaHaHaHaHa
HaHaHaHaHaHaHaHaHaHaHaHaHaHaHaHaHaHaHaHaHaHaHaHaHaHaHaHaHaHaHaHaHaHaHaHaHaHaHaHaHaHaHaHaHaHaHaHaHaHaHaHaHa
HaHaHaHaHaHaHaHaHaHaHaHaHaHaHaHaHaHaHaHaHaHaHaHaHaHaHaHaHaHaHaHaHaHaHaHaHaHaHaHaHaHaHaHaHaHaHaHaHaHaHaHaHa
HaHaHaHaHaHaHaHaHaHaHaHaHaHaHaHaHaHaHaHaHaHaHaHaHaHaHaHaHaHaHaHaHaHaHaHaHaHaHaHaHaHaHaHaHaHaHaHaHaHaHaHaHa
HaHaHaHaHaHaHaHaHaHaHaHaHaHaHaHaHaHaHaHaHaHaHaHaHaHaHaHaHaHaHaHaHaHaHaHaHaHaHaHaHaHaHaHaHaHaHaHaHaHaHaHaHa
HaHaHaHaHaHaHaHaHaHaHaHaHaHaHaHaHaHaHaHaHaHaHaHaHaHaHaHaHaHaHaHaHaHaHaHaHaHaHaHaHaHaHaHaHaHaHaHaHaHaHaHaHa
HaHaHaHaHaHaHaHaHaHaHaHaHaHaHaHaHaHaHaHaHaHaHaHaHaHaHaHaHaHaHaHaHaHaHaHaHaHaHaHaHaHaHaHaHaHaHaHaHaHaHaHaHa
HaHaHaHaHaHaHaHaHaHaHaHaHaHaHaHaHaHaHaHaHaHaHaHaHaHaHaHaHaHaHaHaHaHaHaHaHaHaHaHaHaHaHaHaHaHaHaHaHaHaHaHaHa
HaHaHaHaHaHaHaHaHaHaHaHaHaHaHaHaHaHaHaHaHaHaHaHaHaHaHaHaHaHaHaHaHaHaHaHaHaHaHaHaHaHaHaHaHaHaHaHaHaHaHaHaHa
HaHaHaHaHaHaHaHaHaHaHaHaHaHaHaHaHaHaHaHaHaHaHaHaHaHaHaHaHaHaHaHaHaHaHaHaHaHaHaHaHaHaHaHaHaHaHaHaHaHaHaHaHa
HaHaHaHaHaHaHaHaHaHaHaHaHaHaHaHaHaHaHaHaHaHaHaHaHaHaHaHaHaHaHaHaHaHaHaHaHaHaHaHaHaHaHaHaHaHaHaHaHaHaHaHaHa
HaHaHaHaHaHaHaHaHaHaHaHaHaHaHaHaHaHaHaHaHaHaHaHaHaHaHaHaHaHaHaHaHaHaHaHaHaHaHaHaHaHaHaHaHaHaHaHaHaHaHaHaHa
HaHaHaHaHaHaHaHaHaHaHaHaHaHaHaHaHaHaHaHaHaHaHaHaHaHaHaHaHaHaHaHaHaHaHaHaHaHaHaHaHaHaHaHaHaHaHaHaHaHaHaHaHa
HaHaHaHaHaHaHaHaHaHaHaHaHaHaHaHaHaHaHaHaHaHaHaHaHaHaHaHaHaHaHaHaHaHaHaHaHaHaHaHaHaHaHaHaHaHaHaHaHaHaHaHaHa
HaHaHaHaHaHaHaHaHaHaHaHaHaHaHaHaHaHaHaHaHaHaHaHaHaHaHaHaHaHaHaHaHaHaHaHaHaHaHaHaHaHaHaHaHaHaHaHaHaHaHaHaHa
HaHaHaHaHaHaHaHaHaHaHaHaHaHaHaHaHaHaHaHaHaHaHaHaHaHaHaHaHaHaHaHaHaHaHaHaHaHaHaHaHaHaHaHaHaHaHaHaHaHaHaHaHa
HaHaHaHaHaHaHaHaHaHaHaHaHaHaHaHaHaHaHaHaHaHaHaHaHaHaHaHaHaHaHaHaHaHaHaHaHaHaHaHaHaHaHaHaHaHaHaHaHaHaHaHaHa
HaHaHaHaHaHaHaHaHaHaHaHaHaHaHaHaHaHaHaHaHaHaHaHaHaHaHaHaHaHaHaHaHaHaHaHaHaHaHaHaHaHaHaHaHaHaHaHaHaHaHaHaHa
HaHaHaHaHaHaHaHaHaHaHaHaHaHaHaHaHaHaHaHaHaHaHaHaHaHaHaHaHaHaHaHaHaHaHaHaHaHaHaHaHaHaHaHaHaHaHaHaHaHaHaHaHa
HaHaHaHaHaHaHaHaHaHaHaHaHaHaHaHaHaHaHaHaHaHaHaHaHaHaHaHaHaHaHaHaHaHaHaHaHaHaHaHaHaHaHaHaHaHaHaHaHaHaHaHaHa
HaHaHaHaHaHaHaHaHaHaHaHaHaHaHaHaHaHaHaHaHaHaHaHaHaHaHaHaHaHaHaHaHaHaHaHaHaHaHaHaHaHaHaHaHaHaHaHaHaHaHaHaHa
HaHaHaHaHaHaHaHaHaHaHaHaHaHaHaHaHaHaHaHaHaHaHaHaHaHaHaHaHaHaHaHaHaHaHaHaHaHaHaHaHaHaHaHaHaHaHaHaHaHaHaHaHa
HaHaHaHaHaHaHaHaHaHaHaHaHaHaHaHaHaHaHaHaHaHaHaHaHaHaHaHaHaHaHaHaHaHaHaHaHaHaHaHaHaHaHaHaHaHaHaHaHaHaHaHaHa
HaHaHaHaHaHaHaHaHaHaHaHaHaHaHaHaHaHaHaHaHaHaHaHaHaHaHaHaHaHaHaHaHaHaHaHaHaHaHaHaHaHaHaHaHaHaHaHaHaHaHaHaHa
HaHaHaHaHaHaHaHaHaHaHaHaHaHaHaHaHaHaHaHaHaHaHaHaHaHaHaHaHaHaHaHaHaHaHaHaHaHaHaHaHaHaHaHaHaHaHaHaHaHaHaHaHa
HaHaHaHaHaHaHaHaHaHaHaHaHaHaHaHaHaHaHaHaHaHaHaHaHaHaHaHaHaHaHaHaHaHaHaHaHaHaHaHaHaHaHaHaHaHaHaHaHaHaHaHaHa
HaHaHaHaHaHaHaHaHaHaHaHaHaHaHaHaHaHaHaHaHaHaHaHaHaHaHaHaHaHaHaHaHaHaHaHaHaHaHaHaHaHaHaHaHaHaHaHaHaHaHaHaHa
HaHaHaHaHaHaHaHaHaHaHaHaHaHaHaHaHaHaHaHaHaHaHaHaHaHaHaHaHaHaHaHaHaHaHaHaHaHaHaHaHaHaHaHaHaHaHaHaHaHaHaHaHa
HaHaHaHaHaHaHaHaHaHaHaHaHaHaHaHaHaHaHaHaHaHaHaHaHaHaHaHaHaHaHaHaHaHaHaHaHaHaHaHaHaHaHaHaHaHaHaHaHaHaHaHaHa
HaHaHaHaHaHaHaHaHaHaHaHaHaHaHaHaHaHaHaHaHaHaHaHaHaHaHaHaHaHaHaHaHaHaHaHaHaHaHaHaHaHaHaHaHaHaHaHaHaHaHaHaHa
HaHaHaHaHaHaHaHaHaHaHaHaHaHaHaHaHaHaHaHaHaHaHaHaHaHaHaHaHaHaHaHaHaHaHaHaHaHaHaHaHaHaHaHaHaHaHaHaHaHaHaHaHa
HaHaHaHaHaHaHaHaHaHaHaHaHaHaHaHaHaHaHaHaHaHaHaHaHaHaHaHaHaHaHaHaHaHaHaHaHaHaHaHaHaHaHaHaHaHaHaHaHaHaHaHaHa
HaHaHaHaHaHaHaHaHaHaHaHaHaHaHaHaHaHaHaHaHaHaHaHaHaHaHaHaHaHaHaHaHaHaHaHaHaHaHaHaHaHaHaHaHaHaHaHaHaHaHaHaHa
HaHaHaHaHaHaHaHaHaHaHaHaHaHaHaHaHaHaHaHaHaHaHaHaHaHaHaHaHaHaHaHaHaHaHaHaHaHaHaHaHaHaHaHaHaHaHaHaHaHaHaHaHa
HaHaHaHaHaHaHaqNqNqNqNqNqNqNqNqNqNqNqNqNqNqNqNqNqNqNqNqNqNqNqNqNqNqNqNqNqNqNqNqNqNqNqNqNqNqNHaHaHaHaHaHaHa
HaHaHaHaHaHaHaqNXQXQXQXQXQqNqNqNqNqNqNqNqNXQXQqNqNXQXQXQqNqNXQXQqNqNqNqNqNqNqNqNXQXQXQXQXQqNHaHaHaHaHaHaHa
HaHaHaHaqNqNqNqNrZrZrZrZrZqNqNqNqNqNqNqNptrZrZptqGrZrZrZqGpxrZrZpxqNqNqNqNqNqNqNrZrZrZrZrZqNqNqNqNHaHaHaHa
HaHaHaHaqNqNqNqNkhkhkhkhkhqNqNqNwwwwwwZcZcNNNNZcZcNNNNNNZcZcNNNNZcZcwwwwwwqNqNqNkhkhkhkhkhqNqNqNqNHaHaHaHa
HaHaHaHaqNqNqNqNwwwwwwwwwwqNqNqNwwwwZcZcZcZcZcZcZcZcZcZcZcZcZcZcZcZcZcwwwwwwqNwwwwwwwwwwwwqNqNqNqNHaHaHaHa
HaHaHaHaqNqNqNwwwwwwwwwwwwwwqNwwwwwwZcZcZcZcZcZcZcZcZcZcZcZcZcZcZcZcZcwwwwwwwwwwwwwwwwwwwwwwqNqNqNHaHaHaHa
HaHaHaHaqNqNwwwwwwwwwwwwwwwwwwwwwwwwZcZcZcyqyqyqkhkhkhkhkhyqyqyqZcZcZcwwwwwwwwwwwwwwwwwwwwwwqNqNqNHaHaHaHa
HaHaHaHaqNqNwwwwwwwwwwwwwwwwwwwwwwZcZcZcyqyqkQkQwwwwwwwwwwkQkQyqyqZcZcZcwwwwwwwwwwwwwwwwwwwwwwqNqNHaHaHaHa
HaHaHaHaqNwwwwwwwwwwwwwwwwwwwwwwZcZcZcZcyqkQkQwwkhkhkhkhkhwwkQkQtaZcZcZcZcwwwwwwwwwwwwwwwwwwwwwwqNHaHaHaHa
HaHaHaHaqNwwwwwwwwwwwwwwwwwwwwZcZcZcZcyqyqkQwwZcZcZcZcZcZcZcwwkQyqyqZcZcZcZcwwwwwwwwwwwwwwwwwwwwqNHaHaHaHa
HaHaHaHaqNZcZcZckhZcZcZckhZcZcZcZcZcyqyqkQkQZcZcZcYoHBAjZcZcZckQkQyqyqZcZcZcZcZckhZcZcZckhZcZcZcqNHaHaHaHa
HaHaHaHaqNZcZcZcJtZcZcZcJtZcZcZcZcyqyqkQkQZcZcZckQZcwwZckQZcZcZckQkQyqyqZcZcZcZcJtZcZcZcJtZcZcZcqNHaHaHaHa
HaHaHaHaqNyqyqyqwwyqyqyqwwyqyqyqyqyqkQkQZcZcZckQyqYoueAjtakQZcZcZckQkQyqyqyqyqyqwwyqyqyqwwyqyqyqqNHaHaHaHa
HaHaHaHaqNkQkQkQwwkQkQkQwwkQkQkQkQkQkQwwZcANkQyqrbZcrqZcrbyqkQANZcwwkQkQkQkQkQkQwwkQkQkQwwkQkQkQqNHaHaHaHa
HaHaHaHaqNZcZcZckhZcZcZckhZcZcZcZcwwZckhZckQZcZckhZcZcZckhZcZckQZckhZcwwZcZcZcZckhZcZcZckhZcZcZcqNHaHaHaHa
HaHaHaHaqNZcyqyqJtZcZcZcJtZcZcZcZcpuZcJtZcANANZcyqrbZcrbyqZckQkQZcJtZcpuZcZcZcZcJtZcZcZcJtyqyqZcqNHaHaHaHa
HaHaHaHaqNZckQyqwwyqZcyqwwyqZcyqyqwwyqwwZcZcANkQkQkQkQkQkQkQANZcZcwwyqwwyqyqZcyqwwyqZcyqwwyqkQZcqNHaHaHaHa
HaHaHaHaqNNNkQkQwwkQNNkQwwkQNNkQkQwwwwwwyqZcZcZckhZcZcZckhZcZcZcyqwwwwwwkQkQNNkQwwkQNNkQwwkQkQNNqNHaHaHaHa
HaHaHaHaqNKGZcKGwwKGZcKGwwKGZcKGyqBCHBgNyqyqZcZcJtZcZcZcJtZcZcyqyqBCHBgNyqKGZcKGwwKGZcKGwwKGZcKGqNHaHaHaHa
HaHaHaHaqNyqyqyqwwyqyqyqwwyqyqyqyqwwwwwwwwyqyqyqyqyqyqyqyqyqyqyqwwwwwwwwyqyqyqyqwwyqyqyqwwyqyqyqqNHaHaHaHa
HaHaHaHaqNkQkQkQpukQkQkQpukQkQkQkQpupupukQkQkQkQkQkQkQkQkQkQkQkQkQpupupukQkQkQkQpukQkQkQpukQkQkQqNHaHaHaHa
HaHaHaHaqNZcZcZcZcZcZcZcZcZcZcZcZcZckhZcZcZcZcZcZcZcZcZcZcZcZcZcZcZckhZcZcZcZcZcZcZcZcZcZcZcZcZcqNHaHaHaHa
HaHaHaHaqNZcZcZcZcZcZcZcZcZcZcZcZcZckhZcZcZcZcZcZcZcZcZcZcZcZcZcZcZckhZcZcZcZcZcZcZcZcZcZcZcZcZcqNHaHaHaHa
HaHaHaHaqNAmkhRfZcYoHBAjZcAmkhRfZcvAwwwgZcZcAmkhRfYoHBAjAmkhRfZcZcvAwwwgZcAmkhRfZcYoHBAjZcAmkhRfqNHaHaHaHa
HaHaHaHaqNAmJtRfZcZcJtZcZcAmJtRfZcvAwwwgZcZcAmJtRfZcJtZcAmJtRfZcZcvAwwwgZcAmJtRfZcZcJtZcZcAmJtRfqNHaHaHaHa
HaHaHaHaqNyqyqyqyqyqyqyqyqyqyqyqyqpuwwpuyqyqyqyqyqyqyqyqyqyqyqyqyqpuwwpuyqyqyqyqyqyqyqyqyqyqyqyqqNHaHaHaHa
HaHaHaHaqNkQkQkQkQkQkQkQkQkQkQkQZcyqpuyqZckQkQkQkQkQkQkQkQkQkQkQZcyqpuyqZckQkQkQkQkQkQkQkQkQkQkQqNHaHaHaHa
HaHaHaHaqNwwVxwwVxwwVxwwVxwwVxkQkQZcyqZckQkQVxwwVxwwVxwwVxwwVxkQkQZcyqZckQkQVxwwVxwwVxwwVxwwVxwwqNHaHaHaHa
HaHaHaHaqNVxwwVxwwVxwwVxwwVxwwVxkQkQkQkQkQVxwwVxwwVxwwVxwwVxwwVxkQkQkQkQkQVxwwVxwwVxwwVxwwVxwwVxqNHaHaHaHa
HaHaHaHaqNwwwwwwwwwwwwwwwwwwwwwwVxVxVxVxVxwwwwwwwwwwwwwwwwwwwwwwVxVxVxVxVxwwwwwwwwwwwwwwwwwwwwwwqNHaHaHaHa
HaHaHaHaHaEuEuEuEuEuEuEuEuEuEuEuEuEuEuEuEuEuEuEuEuEuEuEuEuEuEuEuEuEuEuEuEuEuEuEuEuEuEuEuEuEuEuEuHaHaHaHaHa
HaHaHaHaHaEuEuEuEuEuEuEuEuEuEuEuEuEuEuEuEuEuEuEuEuEuEuEuEuEuEuEuEuEuEuEuEuEuEuEuEuEuEuEuEuEuEuEuHaHaHaHaHa
HaHaHaHaHaEuEuEuEuEuEuEuEuEuEuEuEuEuEuEuEuEuEuEuEuEuEuEuEuEuEuEuEuEuEuEuEuEuEuEuEuEuEuEuEuEuEuEuHaHaHaHaHa
HaHaHaHaHaEuEuEuEuEuEuEuEuEuEuEuEuEuEuEuEuEuEuEuEuEuEuEuEuEuEuEuEuEuEuEuEuEuEuEuEuEuEuEuEuEuEuEuHaHaHaHaHa
HaHaHaHaHaEuEuEuEuEuEuEuEuEuEuEuEuEuEuEuEuEuEuEuEuEuEuEuEuEuEuEuEuEuEuEuEuEuEuEuEuEuEuEuEuEuEuEuHaHaHaHaHa
HaHaHaHaHaEuEuEuEuEuEuEuEuEuEuEuEuEuEuEuEuEuEuEuEuEuEuEuEuEuEuEuEuEuEuEuEuEuEuEuEuEuEuEuEuEuEuEuHaHaHaHaHa
HaHaHaHaHaEuEuEuEuEuEuEuEuEuEuEuEuEuEuEuEuEuEuEuEuEuEuEuEuEuEuEuEuEuEuEuEuEuEuEuEuEuEuEuEuEuEuEuHaHaHaHaHa
HaHaHaHaHaEuEuEuEuEuEuEuEuEuEuEuEuEuEuEuEuEuEuEuEuEuEuEuEuEuEuEuEuEuEuEuEuEuEuEuEuEuEuEuEuEuEuEuHaHaHaHaHa
HaHaHaHaHaxpxpxpxpxpyCxpxpxpxpxpxpxpyCxpxpxpxpxpxpxpyCxpxpxpxpxpxpxpyCxpxpxpxpxpxpxpyCxpxpxpxpxpHaHaHaHaHa
HaHaHaHaHaxpxpxpxpxpxpxpxpxpxpxpxpxpxpxpxpxpxpxpxpxpxpxpxpxpxpxpxpxpxpxpxpxpxpxpxpxpxpxpxpxpxpxpHaHaHaHaHa
HaHaHaHaHaxpxpxpxpxpxpxpxpxpxpxpxpxpxpxpxpxpxpxpxpxpxpxpxpxpxpxpxpxpxpxpxpxpxpxpxpxpxpxpxpxpxpxpHaHaHaHaHa
HaHaHaHaHaxpxpxpxpxpxpxpxpxpxpxpxpxpxpxpxpxpxpxpxpxpxpxpxpxpxpxpxpxpxpxpxpxpxpxpxpxpxpxpxpxpxpxpHaHaHaHaHa
HaHaHaHaHaxpxpxpxpxpxpxpxpxpxpxpxpxpxpxpxpxpxpxpxpxpxpxpxpxpxpxpxpxpxpxpxpxpxpxpxpxpxpxpxpxpxpxpHaHaHaHaHa
HaHaHaHaHaxpxpxpxpxpxpxpxpxpxpxpxpxpxpxpxpxpxpxpxpxpxpxpxpxpxpxpxpxpxpxpxpxpxpxpxpxpxpxpxpxpxpxpHaHaHaHaHa
HaHaHaHaHaxpxpxpxpxpxpxpxpxpxpxpxpxpxpxpxpxpxpxpxpxpxpxpxpxpxpxpxpxpxpxpxpxpxpxpxpxpxpxpxpxpxpxpHaHaHaHaHa
HaHaHaHaHanSnSnSnSnSnSnSnSnSnSnSnSnSnSnSnSnSnSnSnSnSnSnSnSnSnSnSnSnSnSnSnSnSnSnSnSnSnSnSnSnSnSnSHaHaHaHaHa
HaHaHaHaqNNNNNNNNNNNNNNNNNNNNNNNNNNNXdNNNNNNNNNNNNNNNNNNNNNNNNNNNNNNXdNNNNNNNNNNNNNNNNNNNNNNNNNNqNHaHaHaHa
HaHaHaHaqNZcZcZcZcZcZcZcZcZcZcZcZcZcKXZcZcZcZcZcZcZcZcZcZcZcZcZcZcZcKXZcZcZcZcZcZcZcZcZcZcZcZcZcqNHaHaHaHa
HaHaHaHaqNZcZcYoAsAjZcZcZcYoAsAjZcZcKXZcZcYoAsAjZcZcapZcZcYoAsAjZcZcKXZcZcYoAsAjZcZcZcYoAsAjZcZcqNHaHaHaHa
HaHaHaHaqNZcZcAmKXRfZcZcZcAmKXRfZcZcKXZcZcZcKXZcZcZcKXZcZcZcKXZcZcZcKXZcZcAmKXRfZcZcZcAmKXRfZcZcqNHaHaHaHa
HaHaHaHaqNZcZcAmKXRfZcZcZcAmKXRfZcZcKXZcZcZcKXZcZcZcKXZcZcZcKXZcZcZcKXZcZcAmKXRfZcZcZcAmKXRfZcZcqNHaHaHaHa
HaHaHaHaqNZcZcZcZcZcZcZcZcZcZcZcZcZcKXZcZcZcZcZcZcZcZcZcZcZcZcZcZcZcKXZcZcZcZcZcZcZcZcZcZcZcZcZcqNHaHaHaHa
HaHaHaHaqNXdXdXdXdXdXdXdXdXdXdXdXdXdXdXdXdXdXdXdXdXdXdXdXdXdXdXdXdXdXdXdXdXdXdXdXdXdXdXdZVZVZVZVqNHaHaHaHa
HaHaHaHaqNZVZVZVZVXdXdxcXdXdXdZVZVZVZVZVZVZVZVZVZVXdXdXdZVZVZVZVZVZVZVZVZVZVXdXdXdSsXdXdZVZVZVZVqNHaHaHaHa
HaHaHaHaqNZVZVZVZVXdKXcuXQXdXdZVZVZVZVZVZVZVZVZVZVXdXdXdZVZVZVZVZVZVZVZVZVZVXdXdXQcxKXXdZVZVZVZVqNHaHaHaHa
HaHaHaHaqNZVZVZVZVXdKXcuXQXdXdZVZVZVZVZVZVZVZVZVZVXdXdXdZVZVZVZVZVZVZVZVZVZVXdXdXQcxKXXdZVZVZVZVqNHaHaHaHa
HaHaHaHaqNZVZVZVZVXdXdXdXdXdXdZVZVZVZVZVZVZVZVZVZVXdXdXdZVZVZVZVZVZVZVZVZVZVXdXdXdXdXdXdZVZVZVZVqNHaHaHaHa
HaHaHaHaqNZVZVZVZVZVZVZVZVZVZVZVZVZVZVZVZVZVZVZVZVXdXdXdZVZVZVZVZVZVZVZVZVZVZVZVZVZVZVZVZVZVZVZVqNHaHaHaHa
HaHaHaHaqNZVZVZVZVZVZVZVZVZVZVZVZVZVZVZVZVZVZVZVXdXdXdXdXdZVZVZVZVZVZVZVZVZVZVZVZVZVZVZVZVZVZVZVqNHaHaHaHa
HaHaHaHaqNZVZVZVZVZVZVZVZVZVZVZVZVZVZVZVZVZVZVZVYXXdXdXdYXZVZVZVZVZVZVZVZVZVZVZVZVZVZVZVZVZVZVZVqNHaHaHaHa
HaHaHaHaqNZVZVZVZVZVZVZVZVZVZVZVZVZVZVZVZVZVZVZVXdKXKXKXXdZVZVZVZVZVZVZVZVZVZVZVZVZVZVZVZVZVZVZVqNHaHaHaHa
HaHaHaHaqNZVZVZVZVZVZVZVZVZVZVZVZVZVZVZVZVZVZVZVXdxYxYxYXdZVZVZVZVZVZVZVZVZVZVZVZVZVZVZVZVZVZVZVqNHaHaHaHa
HaHaHaHaqNZVZVZVZVZVZVZVZVZVZVZVZVZVZVZVZVZVZVZVXdXQXQXQXdZVZVZVZVZVZVZVZVZVZVZVZVZVZVZVZVZVZVZVqNHaHaHaHa
HaHaHaHaqNZVZVZVZVZVZVZVZVZVZVZVZVZVZVZVZVZVZVZVXdXdXdXdXdZVZVZVZVZVZVZVZVZVZVZVZVZVZVZVZVZVZVZVqNHaHaHaHa
HaHaHaHaqNZVZVZVZVZVZVZVZVZVZVZVZVZVZVZVZVZVZVZVXdXdXdXdXdZVZVZVZVZVZVZVZVZVZVZVZVZVZVZVZVZVZVZVqNHaHaHaHa
HaHaHaHaqNZVZVZVZVZVZVZVZVZVZVZVZVZVZVZVZVZVZVZVZVZVZVZVZVZVZVZVZVZVZVZVZVZVZVZVZVZVZVZVZVZVZVZVqNHaHaHaHa
HaHaHaHaqNqNqNqNqNqNqNqNqNqNqNqNqNqNqNqNqNqNqNqNqNqNqNqNqNqNqNqNqNqNqNqNqNqNqNqNqNqNqNqNqNqNqNqNqNHaHaHaHa
HaHaHaHaHaHaHaHaHaHaHaHaHaHaHaHaHaHaHaHaHaHaHaHaHaHaHaHaHaHaHaHaHaHaHaHaHaHaHaHaHaHaHaHaHaHaHaHaHaHaHaHaHa
HaHaHaHaHaHaHaHaHaHaHaHaHaHaHaHaHaHaHaHaHaHaHaHaHaHaHaHaHaHaHaHaHaHaHaHaHaHaHaHaHaHaHaHaHaHaHaHaHaHaHaHaHa
HaHaHaHaHaHaHaHaHaHaHaHaHaHaHaHaHaHaHaHaHaHaHaHaHaHaHaHaHaHaHaHaHaHaHaHaHaHaHaHaHaHaHaHaHaHaHaHaHaHaHaHaHa
HaHaHaHaHaHaHaHaHaHaHaHaHaHaHaHaHaHaHaHaHaHaHaHaHaHaHaHaHaHaHaHaHaHaHaHaHaHaHaHaHaHaHaHaHaHaHaHaHaHaHaHaHa
HaHaHaHaHaHaHaHaHaHaHaHaHaHaHaHaHaHaHaHaHaHaHaHaHaHaHaHaHaHaHaHaHaHaHaHaHaHaHaHaHaHaHaHaHaHaHaHaHaHaHaHaHa
HaHaHaHaHaHaHaHaHaHaHaHaHaHaHaHaHaHaHaHaHaHaHaHaHaHaHaHaHaHaHaHaHaHaHaHaHaHaHaHaHaHaHaHaHaHaHaHaHaHaHaHaHa
HaHaHaHaHaHaHaHaHaHaHaHaHaHaHaHaHaHaHaHaHaHaHaHaHaHaHaHaHaHaHaHaHaHaHaHaHaHaHaHaHaHaHaHaHaHaHaHaHaHaHaHaHa
HaHaHaHaHaHaHaHaHaHaHaHaHaHaHaHaHaHaHaHaHaHaHaHaHaHaHaHaHaHaHaHaHaHaHaHaHaHaHaHaHaHaHaHaHaHaHaHaHaHaHaHaHa
HaHaHaHaHaHaHaHaHaHaHaHaHaHaHaHaHaHaHaHaHaHaHaHaHaHaHaHaHaHaHaHaHaHaHaHaHaHaHaHaHaHaHaHaHaHaHaHaHaHaHaHaHa
HaHaHaHaHaHaHaHaHaHaHaHaHaHaHaHaHaHaHaHaHaHaHaHaHaHaHaHaHaHaHaHaHaHaHaHaHaHaHaHaHaHaHaHaHaHaHaHaHaHaHaHaHa
HaHaHaHaHaHaHaHaHaHaHaHaHaHaHaHaHaHaHaHaHaHaHaHaHaHaHaHaHaHaHaHaHaHaHaHaHaHaHaHaHaHaHaHaHaHaHaHaHaHaHaHaHa
HaHaHaHaHaHaHaHaHaHaHaHaHaHaHaHaHaHaHaHaHaHaHaHaHaHaHaHaHaHaHaHaHaHaHaHaHaHaHaHaHaHaHaHaHaHaHaHaHaHaHaHaHa
HaHaHaHaHaHaHaHaHaHaHaHaHaHaHaHaHaHaHaHaHaHaHaHaHaHaHaHaHaHaHaHaHaHaHaHaHaHaHaHaHaHaHaHaHaHaHaHaHaHaHaHaHa
HaHaHaHaHaHaHaHaHaHaHaHaHaHaHaHaHaHaHaHaHaHaHaHaHaHaHaHaHaHaHaHaHaHaHaHaHaHaHaHaHaHaHaHaHaHaHaHaHaHaHaHaHa
HaHaHaHaHaHaHaHaHaHaHaHaHaHaHaHaHaHaHaHaHaHaHaHaHaHaHaHaHaHaHaHaHaHaHaHaHaHaHaHaHaHaHaHaHaHaHaHaHaHaHaHaHa
HaHaHaHaHaHaHaHaHaHaHaHaHaHaHaHaHaHaHaHaHaHaHaHaHaHaHaHaHaHaHaHaHaHaHaHaHaHaHaHaHaHaHaHaHaHaHaHaHaHaHaHaHa
afHaHaHaHaHaHaHaHaHaHaHaHaHaHaHaHaHaHaHaHaHaHaHaHaHaHaHaHaHaHaHaHaHaHaHaHaHaHaHaHaHaHaHaHaHaHaHaHaHaHaHaHa
"}
