"a" = (/turf/template_noop,/area/template_noop)
"b" = (/turf/simulated/wall,/area/mine/explored)
"c" = (/obj/structure/filingcabinet,/obj/effect/decal/cleanable/cobweb,/turf/simulated/floor/tiled/dark,/area/mine/explored)
"d" = (/obj/structure/bookcase/manuals/xenoarchaeology,/turf/simulated/floor/tiled/dark,/area/mine/explored)
"e" = (/obj/effect/decal/cleanable/cobweb2,/obj/random/canned_food,/obj/random/canned_food,/obj/random/canned_food,/obj/structure/closet/crate,/turf/simulated/floor/tiled/dark,/area/mine/explored)
"f" = (/obj/random/trash,/obj/structure/inflatable/door,/turf/simulated/floor/tiled/dark,/area/mine/explored)
"g" = (/obj/random/junk,/obj/random/loot,/turf/simulated/floor/tiled/dark,/area/mine/explored)
"h" = (/turf/simulated/floor/tiled/dark,/area/mine/explored)
"i" = (/obj/structure/inflatable/door,/turf/simulated/floor/tiled/dark,/area/mine/explored)
"j" = (/obj/structure/girder/reinforced,/turf/simulated/floor/plating,/area/mine/explored)
"k" = (/obj/structure/table/rack,/obj/item/clothing/glasses/eyepatch/hud/medical,/obj/random/loot,/obj/random/loot,/obj/random/hat,/turf/simulated/floor/tiled/dark,/area/mine/explored)
"l" = (/obj/structure/sign/science_1{pixel_y = 32},/turf/simulated/floor/tiled/dark,/area/mine/explored)
"m" = (/obj/machinery/artifact_scanpad,/turf/simulated/floor/tiled/dark,/area/mine/explored)
"n" = (/obj/structure/gravemarker/random,/turf/template_noop,/area/template_noop)
"o" = (/obj/item/pen/multi,/turf/simulated/floor/tiled/dark,/area/mine/explored)
"p" = (/obj/structure/bed/chair/wheelchair,/turf/simulated/floor/tiled/dark,/area/mine/explored)
"q" = (/obj/structure/curtain/black,/turf/simulated/floor/carpet,/area/mine/explored)
"r" = (/obj/machinery/r_n_d/server,/turf/simulated/floor/tiled/dark,/area/mine/explored)
"s" = (/obj/structure/table/marble,/obj/item/device/flashlight/lamp,/turf/simulated/floor/tiled/dark,/area/mine/explored)
"t" = (/obj/structure/table/marble,/obj/item/paper_bin,/obj/random/handgun,/turf/simulated/floor/tiled/dark,/area/mine/explored)
"u" = (/obj/structure/bed,/obj/item/bedsheet/rainbow,/obj/random/drinkbottle,/obj/random/trash,/turf/simulated/floor/carpet,/area/mine/explored)

(1,1,1) = {"
bbbbban
bcdebfb
bghhbib
jkhhlhb
bmopbqb
brstbub
bbbbbbb
"}
